"soe","month","month_num","year","total_arrivals","arrivals_male","arrivals_female"
"Johor","April","04","2020",296,236,60
"Johor","April","04","2021",842,748,94
"Johor","April","04","2022",435671,268606,167065
"Johor","April","04","2023",1227351,682404,544947
"Johor","April","04","2024",1637745,912098,725647
"Johor","August","08","2020",831,759,72
"Johor","August","08","2021",185,154,31
"Johor","August","08","2022",1122353,654584,467769
"Johor","August","08","2023",1510486,844529,665957
"Johor","December","12","2020",947,825,122
"Johor","December","12","2021",3185,1785,1400
"Johor","December","12","2022",1395639,749842,645797
"Johor","December","12","2023",1753136,934618,818518
"Johor","February","02","2020",1093546,671718,421828
"Johor","February","02","2021",819,720,99
"Johor","February","02","2022",3236,1876,1360
"Johor","February","02","2023",1096031,629023,467008
"Johor","February","02","2024",1389651,768268,621383
"Johor","January","01","2020",1621595,905601,715994
"Johor","January","01","2021",752,663,89
"Johor","January","01","2022",4815,2632,2183
"Johor","January","01","2023",1234076,693195,540881
"Johor","January","01","2024",1155378,639527,515851
"Johor","July","07","2020",811,686,125
"Johor","July","07","2021",197,163,34
"Johor","July","07","2022",1125995,655916,470079
"Johor","July","07","2023",1545948,850439,695509
"Johor","June","06","2020",387,344,43
"Johor","June","06","2021",134,114,20
"Johor","June","06","2022",943173,546327,396846
"Johor","June","06","2023",1510345,820088,690257
"Johor","June","06","2024",2077267,1112617,964650
"Johor","March","03","2020",669826,409015,260811
"Johor","March","03","2021",932,819,113
"Johor","March","03","2022",8338,4931,3407
"Johor","March","03","2023",1301585,727417,574168
"Johor","March","03","2024",1882339,1010380,871959
"Johor","May","05","2020",221,206,15
"Johor","May","05","2021",449,412,37
"Johor","May","05","2022",709855,431647,278208
"Johor","May","05","2023",1298501,738863,559638
"Johor","May","05","2024",1793130,988447,804683
"Johor","November","11","2020",1017,908,109
"Johor","November","11","2021",620,448,172
"Johor","November","11","2022",1214628,685950,528678
"Johor","November","11","2023",1558439,856873,701566
"Johor","October","10","2020",1154,1053,101
"Johor","October","10","2021",306,255,51
"Johor","October","10","2022",1208015,684451,523564
"Johor","October","10","2023",1575638,879290,696348
"Johor","September","09","2020",1314,1196,118
"Johor","September","09","2021",206,171,35
"Johor","September","09","2022",1202442,680944,521498
"Johor","September","09","2023",1599539,881702,717837
"Kedah","April","04","2020",13837,13161,676
"Kedah","April","04","2021",17851,17811,40
"Kedah","April","04","2022",21177,18506,2671
"Kedah","April","04","2023",85744,45197,40547
"Kedah","April","04","2024",68372,36233,32139
"Kedah","August","08","2020",10339,9527,812
"Kedah","August","08","2021",16343,16303,40
"Kedah","August","08","2022",49025,31879,17146
"Kedah","August","08","2023",76758,42486,34272
"Kedah","December","12","2020",14207,13895,312
"Kedah","December","12","2021",18257,18143,114
"Kedah","December","12","2022",76994,42791,34203
"Kedah","December","12","2023",106836,58873,47963
"Kedah","February","02","2020",64428,25646,38782
"Kedah","February","02","2021",16131,16088,43
"Kedah","February","02","2022",16919,16704,215
"Kedah","February","02","2023",82858,46952,35906
"Kedah","February","02","2024",104399,56535,47864
"Kedah","January","01","2020",85071,35097,49974
"Kedah","January","01","2021",17928,17913,15
"Kedah","January","01","2022",18605,18428,177
"Kedah","January","01","2023",85209,47879,37330
"Kedah","January","01","2024",110507,61870,48637
"Kedah","July","07","2020",10020,9349,671
"Kedah","July","07","2021",17481,17441,40
"Kedah","July","07","2022",53769,31280,22489
"Kedah","July","07","2023",85599,46887,38712
"Kedah","June","06","2020",11743,11001,742
"Kedah","June","06","2021",16891,16846,45
"Kedah","June","06","2022",43811,28242,15569
"Kedah","June","06","2023",77066,41554,35512
"Kedah","June","06","2024",72074,37301,34773
"Kedah","March","03","2020",37180,16441,20739
"Kedah","March","03","2021",19205,19153,52
"Kedah","March","03","2022",20277,19980,297
"Kedah","March","03","2023",100620,56619,44001
"Kedah","March","03","2024",101507,55998,45509
"Kedah","May","05","2020",12924,12109,815
"Kedah","May","05","2021",18426,18383,43
"Kedah","May","05","2022",31734,22805,8929
"Kedah","May","05","2023",91007,49427,41580
"Kedah","May","05","2024",88882,46709,42173
"Kedah","November","11","2020",10592,9806,786
"Kedah","November","11","2021",18318,18257,61
"Kedah","November","11","2022",74452,43350,31102
"Kedah","November","11","2023",90711,51274,39437
"Kedah","October","10","2020",9606,8867,739
"Kedah","October","10","2021",19383,19342,41
"Kedah","October","10","2022",76669,42765,33904
"Kedah","October","10","2023",98794,55547,43247
"Kedah","September","09","2020",9295,8594,701
"Kedah","September","09","2021",18833,18787,46
"Kedah","September","09","2022",53695,30908,22787
"Kedah","September","09","2023",85836,49393,36443
"Kelantan","April","04","2020",22,5,17
"Kelantan","April","04","2021",5,2,3
"Kelantan","April","04","2022",8,7,1
"Kelantan","April","04","2023",46894,23322,23572
"Kelantan","April","04","2024",55767,27666,28101
"Kelantan","August","08","2020",3,1,2
"Kelantan","August","08","2021",0,0,0
"Kelantan","August","08","2022",29539,14719,14820
"Kelantan","August","08","2023",35798,19658,16140
"Kelantan","December","12","2020",2,1,1
"Kelantan","December","12","2021",0,0,0
"Kelantan","December","12","2022",26458,13404,13054
"Kelantan","December","12","2023",42337,21688,20649
"Kelantan","February","02","2020",39680,21932,17748
"Kelantan","February","02","2021",3,1,2
"Kelantan","February","02","2022",15,6,9
"Kelantan","February","02","2023",51162,27656,23506
"Kelantan","February","02","2024",56124,28910,27214
"Kelantan","January","01","2020",40002,21170,18832
"Kelantan","January","01","2021",0,0,0
"Kelantan","January","01","2022",4,1,3
"Kelantan","January","01","2023",49955,26718,23237
"Kelantan","January","01","2024",53671,28095,25576
"Kelantan","July","07","2020",9,1,8
"Kelantan","July","07","2021",3,1,2
"Kelantan","July","07","2022",16009,7651,8358
"Kelantan","July","07","2023",50017,26773,23244
"Kelantan","June","06","2020",21,3,18
"Kelantan","June","06","2021",1,0,1
"Kelantan","June","06","2022",8887,3963,4924
"Kelantan","June","06","2023",36763,19306,17457
"Kelantan","June","06","2024",51685,25848,25837
"Kelantan","March","03","2020",20605,10704,9901
"Kelantan","March","03","2021",4,2,2
"Kelantan","March","03","2022",14,13,1
"Kelantan","March","03","2023",58591,29810,28781
"Kelantan","March","03","2024",61724,30496,31228
"Kelantan","May","05","2020",18,6,12
"Kelantan","May","05","2021",1,1,0
"Kelantan","May","05","2022",3846,1929,1917
"Kelantan","May","05","2023",52302,27611,24691
"Kelantan","May","05","2024",57354,29172,28182
"Kelantan","November","11","2020",5,2,3
"Kelantan","November","11","2021",4,0,4
"Kelantan","November","11","2022",33210,17724,15486
"Kelantan","November","11","2023",40481,21136,19345
"Kelantan","October","10","2020",1,0,1
"Kelantan","October","10","2021",0,0,0
"Kelantan","October","10","2022",38130,19621,18509
"Kelantan","October","10","2023",47679,25452,22227
"Kelantan","September","09","2020",7,1,6
"Kelantan","September","09","2021",6,4,2
"Kelantan","September","09","2022",30029,15427,14602
"Kelantan","September","09","2023",35224,19490,15734
"Melaka","April","04","2020",0,0,0
"Melaka","April","04","2021",0,0,0
"Melaka","April","04","2022",16,10,6
"Melaka","April","04","2023",5639,2551,3088
"Melaka","April","04","2024",4776,2122,2654
"Melaka","August","08","2020",0,0,0
"Melaka","August","08","2021",0,0,0
"Melaka","August","08","2022",6512,2778,3734
"Melaka","August","08","2023",3466,1678,1788
"Melaka","December","12","2020",10,10,0
"Melaka","December","12","2021",0,0,0
"Melaka","December","12","2022",8007,3550,4457
"Melaka","December","12","2023",5419,2320,3099
"Melaka","February","02","2020",3236,1502,1734
"Melaka","February","02","2021",0,0,0
"Melaka","February","02","2022",0,0,0
"Melaka","February","02","2023",5254,2330,2924
"Melaka","February","02","2024",3291,1479,1812
"Melaka","January","01","2020",6015,2813,3202
"Melaka","January","01","2021",0,0,0
"Melaka","January","01","2022",0,0,0
"Melaka","January","01","2023",5387,2439,2948
"Melaka","January","01","2024",3497,1663,1834
"Melaka","July","07","2020",0,0,0
"Melaka","July","07","2021",2,1,1
"Melaka","July","07","2022",6265,2683,3582
"Melaka","July","07","2023",5261,2352,2909
"Melaka","June","06","2020",0,0,0
"Melaka","June","06","2021",0,0,0
"Melaka","June","06","2022",5730,2585,3145
"Melaka","June","06","2023",5218,2463,2755
"Melaka","June","06","2024",5367,2433,2934
"Melaka","March","03","2020",1040,500,540
"Melaka","March","03","2021",2,0,2
"Melaka","March","03","2022",13,0,13
"Melaka","March","03","2023",4596,2112,2484
"Melaka","March","03","2024",3074,1413,1661
"Melaka","May","05","2020",0,0,0
"Melaka","May","05","2021",0,0,0
"Melaka","May","05","2022",2979,1356,1623
"Melaka","May","05","2023",5255,2309,2946
"Melaka","May","05","2024",3982,1770,2212
"Melaka","November","11","2020",0,0,0
"Melaka","November","11","2021",3,3,0
"Melaka","November","11","2022",5202,2374,2828
"Melaka","November","11","2023",3716,1708,2008
"Melaka","October","10","2020",2,1,1
"Melaka","October","10","2021",0,0,0
"Melaka","October","10","2022",6778,3113,3665
"Melaka","October","10","2023",3539,1571,1968
"Melaka","September","09","2020",0,0,0
"Melaka","September","09","2021",0,0,0
"Melaka","September","09","2022",7883,3526,4357
"Melaka","September","09","2023",4227,1879,2348
"Negeri Sembilan","April","04","2020",1,1,0
"Negeri Sembilan","April","04","2021",0,0,0
"Negeri Sembilan","April","04","2022",6,5,1
"Negeri Sembilan","April","04","2023",4340,2174,2166
"Negeri Sembilan","April","04","2024",5204,3169,2035
"Negeri Sembilan","August","08","2020",0,0,0
"Negeri Sembilan","August","08","2021",0,0,0
"Negeri Sembilan","August","08","2022",7508,5244,2264
"Negeri Sembilan","August","08","2023",7275,4710,2565
"Negeri Sembilan","December","12","2020",0,0,0
"Negeri Sembilan","December","12","2021",0,0,0
"Negeri Sembilan","December","12","2022",7009,4512,2497
"Negeri Sembilan","December","12","2023",5127,2649,2478
"Negeri Sembilan","February","02","2020",3259,2150,1109
"Negeri Sembilan","February","02","2021",0,0,0
"Negeri Sembilan","February","02","2022",0,0,0
"Negeri Sembilan","February","02","2023",9828,6595,3233
"Negeri Sembilan","February","02","2024",4411,2567,1844
"Negeri Sembilan","January","01","2020",3398,2184,1214
"Negeri Sembilan","January","01","2021",0,0,0
"Negeri Sembilan","January","01","2022",0,0,0
"Negeri Sembilan","January","01","2023",8081,5576,2505
"Negeri Sembilan","January","01","2024",4844,2802,2042
"Negeri Sembilan","July","07","2020",0,0,0
"Negeri Sembilan","July","07","2021",0,0,0
"Negeri Sembilan","July","07","2022",6090,4057,2033
"Negeri Sembilan","July","07","2023",6499,4501,1998
"Negeri Sembilan","June","06","2020",0,0,0
"Negeri Sembilan","June","06","2021",0,0,0
"Negeri Sembilan","June","06","2022",5760,4021,1739
"Negeri Sembilan","June","06","2023",5034,3303,1731
"Negeri Sembilan","June","06","2024",7176,4300,2876
"Negeri Sembilan","March","03","2020",1694,1141,553
"Negeri Sembilan","March","03","2021",0,0,0
"Negeri Sembilan","March","03","2022",0,0,0
"Negeri Sembilan","March","03","2023",8450,5520,2930
"Negeri Sembilan","March","03","2024",4954,2816,2138
"Negeri Sembilan","May","05","2020",0,0,0
"Negeri Sembilan","May","05","2021",0,0,0
"Negeri Sembilan","May","05","2022",2778,1806,972
"Negeri Sembilan","May","05","2023",14303,10163,4140
"Negeri Sembilan","May","05","2024",9700,6429,3271
"Negeri Sembilan","November","11","2020",0,0,0
"Negeri Sembilan","November","11","2021",0,0,0
"Negeri Sembilan","November","11","2022",6805,4590,2215
"Negeri Sembilan","November","11","2023",5535,3388,2147
"Negeri Sembilan","October","10","2020",0,0,0
"Negeri Sembilan","October","10","2021",0,0,0
"Negeri Sembilan","October","10","2022",7422,5074,2348
"Negeri Sembilan","October","10","2023",5098,3048,2050
"Negeri Sembilan","September","09","2020",0,0,0
"Negeri Sembilan","September","09","2021",0,0,0
"Negeri Sembilan","September","09","2022",6848,4706,2142
"Negeri Sembilan","September","09","2023",6045,3875,2170
"Pahang","April","04","2020",0,0,0
"Pahang","April","04","2021",3,3,0
"Pahang","April","04","2022",41,31,10
"Pahang","April","04","2023",838,448,390
"Pahang","April","04","2024",695,377,318
"Pahang","August","08","2020",0,0,0
"Pahang","August","08","2021",0,0,0
"Pahang","August","08","2022",190,141,49
"Pahang","August","08","2023",752,428,324
"Pahang","December","12","2020",1,1,0
"Pahang","December","12","2021",0,0,0
"Pahang","December","12","2022",721,355,366
"Pahang","December","12","2023",1284,649,635
"Pahang","February","02","2020",449,279,170
"Pahang","February","02","2021",0,0,0
"Pahang","February","02","2022",0,0,0
"Pahang","February","02","2023",220,122,98
"Pahang","February","02","2024",714,367,347
"Pahang","January","01","2020",1068,550,518
"Pahang","January","01","2021",0,0,0
"Pahang","January","01","2022",0,0,0
"Pahang","January","01","2023",502,270,232
"Pahang","January","01","2024",556,313,243
"Pahang","July","07","2020",0,0,0
"Pahang","July","07","2021",0,0,0
"Pahang","July","07","2022",85,67,18
"Pahang","July","07","2023",716,396,320
"Pahang","June","06","2020",0,0,0
"Pahang","June","06","2021",0,0,0
"Pahang","June","06","2022",53,43,10
"Pahang","June","06","2023",998,523,475
"Pahang","June","06","2024",1226,666,560
"Pahang","March","03","2020",271,147,124
"Pahang","March","03","2021",1,1,0
"Pahang","March","03","2022",0,0,0
"Pahang","March","03","2023",261,145,116
"Pahang","March","03","2024",1111,614,497
"Pahang","May","05","2020",2,2,0
"Pahang","May","05","2021",3,3,0
"Pahang","May","05","2022",92,72,20
"Pahang","May","05","2023",804,466,338
"Pahang","May","05","2024",1123,632,491
"Pahang","November","11","2020",0,0,0
"Pahang","November","11","2021",0,0,0
"Pahang","November","11","2022",59,36,23
"Pahang","November","11","2023",761,401,360
"Pahang","October","10","2020",0,0,0
"Pahang","October","10","2021",0,0,0
"Pahang","October","10","2022",132,94,38
"Pahang","October","10","2023",972,585,387
"Pahang","September","09","2020",1,1,0
"Pahang","September","09","2021",0,0,0
"Pahang","September","09","2022",230,162,68
"Pahang","September","09","2023",1103,600,503
"Perak","April","04","2020",2,0,2
"Perak","April","04","2021",10,4,6
"Perak","April","04","2022",1241,585,656
"Perak","April","04","2023",19131,8797,10334
"Perak","April","04","2024",19059,8806,10253
"Perak","August","08","2020",4,3,1
"Perak","August","08","2021",3,1,2
"Perak","August","08","2022",12303,5908,6395
"Perak","August","08","2023",19302,9118,10184
"Perak","December","12","2020",6,3,3
"Perak","December","12","2021",12,7,5
"Perak","December","12","2022",18264,8737,9527
"Perak","December","12","2023",22667,10285,12382
"Perak","February","02","2020",15691,7469,8222
"Perak","February","02","2021",6,2,4
"Perak","February","02","2022",13,3,10
"Perak","February","02","2023",15986,7728,8258
"Perak","February","02","2024",19533,9124,10409
"Perak","January","01","2020",21169,10042,11127
"Perak","January","01","2021",9,4,5
"Perak","January","01","2022",13,5,8
"Perak","January","01","2023",15179,7281,7898
"Perak","January","01","2024",16969,7976,8993
"Perak","July","07","2020",10,1,9
"Perak","July","07","2021",1,0,1
"Perak","July","07","2022",10885,5257,5628
"Perak","July","07","2023",21446,9793,11653
"Perak","June","06","2020",5,2,3
"Perak","June","06","2021",1,1,0
"Perak","June","06","2022",7696,3642,4054
"Perak","June","06","2023",18571,8623,9948
"Perak","June","06","2024",20088,9419,10669
"Perak","March","03","2020",9620,4511,5109
"Perak","March","03","2021",4,0,4
"Perak","March","03","2022",8,6,2
"Perak","March","03","2023",21201,10068,11133
"Perak","March","03","2024",22246,10455,11791
"Perak","May","05","2020",0,0,0
"Perak","May","05","2021",9,2,7
"Perak","May","05","2022",2943,1275,1668
"Perak","May","05","2023",20150,9570,10580
"Perak","May","05","2024",16818,7779,9039
"Perak","November","11","2020",15,7,8
"Perak","November","11","2021",5,3,2
"Perak","November","11","2022",15485,7371,8114
"Perak","November","11","2023",19230,8939,10291
"Perak","October","10","2020",5,2,3
"Perak","October","10","2021",7,2,5
"Perak","October","10","2022",14232,6674,7558
"Perak","October","10","2023",18819,8679,10140
"Perak","September","09","2020",3,1,2
"Perak","September","09","2021",2,0,2
"Perak","September","09","2022",9785,5006,4779
"Perak","September","09","2023",17552,8141,9411
"Perlis","April","04","2020",2,0,2
"Perlis","April","04","2021",8160,7879,281
"Perlis","April","04","2022",10089,9814,275
"Perlis","April","04","2023",54352,31556,22796
"Perlis","April","04","2024",55692,31206,24486
"Perlis","August","08","2020",4320,4195,125
"Perlis","August","08","2021",7382,7321,61
"Perlis","August","08","2022",65702,39807,25895
"Perlis","August","08","2023",48127,27786,20341
"Perlis","December","12","2020",8797,8411,386
"Perlis","December","12","2021",9208,9061,147
"Perlis","December","12","2022",54034,32716,21318
"Perlis","December","12","2023",53904,30699,23205
"Perlis","February","02","2020",45831,26593,19238
"Perlis","February","02","2021",9335,8951,384
"Perlis","February","02","2022",8533,8416,117
"Perlis","February","02","2023",56894,34793,22101
"Perlis","February","02","2024",58854,33724,25130
"Perlis","January","01","2020",52560,30518,22042
"Perlis","January","01","2021",9933,9483,450
"Perlis","January","01","2022",9168,9012,156
"Perlis","January","01","2023",59072,36310,22762
"Perlis","January","01","2024",58898,35138,23760
"Perlis","July","07","2020",2564,2511,53
"Perlis","July","07","2021",6961,6879,82
"Perlis","July","07","2022",50675,31822,18853
"Perlis","July","07","2023",65446,38392,27054
"Perlis","June","06","2020",3,0,3
"Perlis","June","06","2021",7248,7164,84
"Perlis","June","06","2022",41620,26753,14867
"Perlis","June","06","2023",46491,26832,19659
"Perlis","June","06","2024",52325,29122,23203
"Perlis","March","03","2020",29630,17261,12369
"Perlis","March","03","2021",10974,10616,358
"Perlis","March","03","2022",10164,10007,157
"Perlis","March","03","2023",69607,42179,27428
"Perlis","March","03","2024",59513,34402,25111
"Perlis","May","05","2020",24,3,21
"Perlis","May","05","2021",8617,8382,235
"Perlis","May","05","2022",25309,17785,7524
"Perlis","May","05","2023",62963,37883,25080
"Perlis","May","05","2024",51422,29370,22052
"Perlis","November","11","2020",6796,6467,329
"Perlis","November","11","2021",7404,7291,113
"Perlis","November","11","2022",55300,34064,21236
"Perlis","November","11","2023",55721,32157,23564
"Perlis","October","10","2020",5489,5275,214
"Perlis","October","10","2021",7956,7845,111
"Perlis","October","10","2022",58279,34034,24245
"Perlis","October","10","2023",60062,33111,26951
"Perlis","September","09","2020",5202,5042,160
"Perlis","September","09","2021",7743,7662,81
"Perlis","September","09","2022",48378,29251,19127
"Perlis","September","09","2023",53629,31041,22588
"Pulau Pinang","April","04","2020",11,10,1
"Pulau Pinang","April","04","2021",109,63,46
"Pulau Pinang","April","04","2022",10484,5565,4919
"Pulau Pinang","April","04","2023",76242,35061,41181
"Pulau Pinang","April","04","2024",85610,39921,45689
"Pulau Pinang","August","08","2020",36,22,14
"Pulau Pinang","August","08","2021",257,194,63
"Pulau Pinang","August","08","2022",45781,21281,24500
"Pulau Pinang","August","08","2023",91936,43292,48644
"Pulau Pinang","December","12","2020",96,63,33
"Pulau Pinang","December","12","2021",366,239,127
"Pulau Pinang","December","12","2022",65816,30457,35359
"Pulau Pinang","December","12","2023",107555,50553,57002
"Pulau Pinang","February","02","2020",46197,21990,24207
"Pulau Pinang","February","02","2021",101,65,36
"Pulau Pinang","February","02","2022",471,387,84
"Pulau Pinang","February","02","2023",65039,30647,34392
"Pulau Pinang","February","02","2024",88273,41291,46982
"Pulau Pinang","January","01","2020",66139,30241,35898
"Pulau Pinang","January","01","2021",91,49,42
"Pulau Pinang","January","01","2022",266,167,99
"Pulau Pinang","January","01","2023",68457,30865,37592
"Pulau Pinang","January","01","2024",98132,44646,53486
"Pulau Pinang","July","07","2020",24,10,14
"Pulau Pinang","July","07","2021",162,93,69
"Pulau Pinang","July","07","2022",43801,20401,23400
"Pulau Pinang","July","07","2023",96735,44357,52378
"Pulau Pinang","June","06","2020",18,4,14
"Pulau Pinang","June","06","2021",347,323,24
"Pulau Pinang","June","06","2022",38589,18547,20042
"Pulau Pinang","June","06","2023",102625,47470,55155
"Pulau Pinang","June","06","2024",112060,51518,60542
"Pulau Pinang","March","03","2020",23117,10935,12182
"Pulau Pinang","March","03","2021",157,99,58
"Pulau Pinang","March","03","2022",1619,935,684
"Pulau Pinang","March","03","2023",74385,35487,38898
"Pulau Pinang","March","03","2024",124257,57580,66677
"Pulau Pinang","May","05","2020",1,1,0
"Pulau Pinang","May","05","2021",134,90,44
"Pulau Pinang","May","05","2022",24031,11961,12070
"Pulau Pinang","May","05","2023",82247,39064,43183
"Pulau Pinang","May","05","2024",99646,46644,53002
"Pulau Pinang","November","11","2020",98,68,30
"Pulau Pinang","November","11","2021",366,235,131
"Pulau Pinang","November","11","2022",54970,25382,29588
"Pulau Pinang","November","11","2023",94156,44464,49692
"Pulau Pinang","October","10","2020",66,46,20
"Pulau Pinang","October","10","2021",282,170,112
"Pulau Pinang","October","10","2022",55019,25274,29745
"Pulau Pinang","October","10","2023",86296,40163,46133
"Pulau Pinang","September","09","2020",26,21,5
"Pulau Pinang","September","09","2021",267,197,70
"Pulau Pinang","September","09","2022",49737,22618,27119
"Pulau Pinang","September","09","2023",87334,42280,45054
"Sabah","April","04","2020",18,2,16
"Sabah","April","04","2021",7,5,2
"Sabah","April","04","2022",1733,941,792
"Sabah","April","04","2023",36694,17302,19392
"Sabah","April","04","2024",39348,17643,21705
"Sabah","August","08","2020",37,18,19
"Sabah","August","08","2021",7,5,2
"Sabah","August","08","2022",19225,9137,10088
"Sabah","August","08","2023",9825,4896,4929
"Sabah","December","12","2020",11,8,3
"Sabah","December","12","2021",28,13,15
"Sabah","December","12","2022",29583,13640,15943
"Sabah","December","12","2023",52232,23676,28556
"Sabah","February","02","2020",30157,14245,15912
"Sabah","February","02","2021",18,8,10
"Sabah","February","02","2022",18,10,8
"Sabah","February","02","2023",33907,15549,18358
"Sabah","February","02","2024",68963,30981,37982
"Sabah","January","01","2020",64829,29285,35544
"Sabah","January","01","2021",10,6,4
"Sabah","January","01","2022",40,19,21
"Sabah","January","01","2023",37889,17466,20423
"Sabah","January","01","2024",67279,29696,37583
"Sabah","July","07","2020",95,31,64
"Sabah","July","07","2021",5,5,0
"Sabah","July","07","2022",19694,9315,10379
"Sabah","July","07","2023",31337,14535,16802
"Sabah","June","06","2020",33,6,27
"Sabah","June","06","2021",4,2,2
"Sabah","June","06","2022",10590,5082,5508
"Sabah","June","06","2023",25499,12113,13386
"Sabah","June","06","2024",59708,26005,33703
"Sabah","March","03","2020",7280,3907,3373
"Sabah","March","03","2021",18,18,0
"Sabah","March","03","2022",30,15,15
"Sabah","March","03","2023",37411,17004,20407
"Sabah","March","03","2024",50964,21968,28996
"Sabah","May","05","2020",19,11,8
"Sabah","May","05","2021",12,6,6
"Sabah","May","05","2022",5174,2686,2488
"Sabah","May","05","2023",41970,19557,22413
"Sabah","May","05","2024",47592,21425,26167
"Sabah","November","11","2020",5,4,1
"Sabah","November","11","2021",35,19,16
"Sabah","November","11","2022",21324,10170,11154
"Sabah","November","11","2023",30563,14346,16217
"Sabah","October","10","2020",2,2,0
"Sabah","October","10","2021",10,7,3
"Sabah","October","10","2022",17484,8372,9112
"Sabah","October","10","2023",7936,4102,3834
"Sabah","September","09","2020",21,9,12
"Sabah","September","09","2021",2,1,1
"Sabah","September","09","2022",17259,8460,8799
"Sabah","September","09","2023",9078,4479,4599
"Sarawak","April","04","2020",470,438,32
"Sarawak","April","04","2021",981,952,29
"Sarawak","April","04","2022",3082,2160,922
"Sarawak","April","04","2023",173088,90593,82495
"Sarawak","April","04","2024",231503,122358,109145
"Sarawak","August","08","2020",808,724,84
"Sarawak","August","08","2021",702,682,20
"Sarawak","August","08","2022",63655,35833,27822
"Sarawak","August","08","2023",112505,61296,51209
"Sarawak","December","12","2020",853,829,24
"Sarawak","December","12","2021",694,627,67
"Sarawak","December","12","2022",193715,99084,94631
"Sarawak","December","12","2023",230361,120799,109562
"Sarawak","February","02","2020",100480,60537,39943
"Sarawak","February","02","2021",756,740,16
"Sarawak","February","02","2022",778,707,71
"Sarawak","February","02","2023",132326,72075,60251
"Sarawak","February","02","2024",190621,101221,89400
"Sarawak","January","01","2020",140162,80142,60020
"Sarawak","January","01","2021",946,915,31
"Sarawak","January","01","2022",1008,913,95
"Sarawak","January","01","2023",140685,76058,64627
"Sarawak","January","01","2024",176310,95746,80564
"Sarawak","July","07","2020",1193,1105,88
"Sarawak","July","07","2021",976,953,23
"Sarawak","July","07","2022",35179,20376,14803
"Sarawak","July","07","2023",128541,68707,59834
"Sarawak","June","06","2020",946,902,44
"Sarawak","June","06","2021",811,788,23
"Sarawak","June","06","2022",29014,17923,11091
"Sarawak","June","06","2023",120392,64628,55764
"Sarawak","June","06","2024",205241,108896,96345
"Sarawak","March","03","2020",49502,30001,19501
"Sarawak","March","03","2021",1087,1059,28
"Sarawak","March","03","2022",950,880,70
"Sarawak","March","03","2023",141193,77147,64046
"Sarawak","March","03","2024",214777,112393,102384
"Sarawak","May","05","2020",454,432,22
"Sarawak","May","05","2021",899,878,21
"Sarawak","May","05","2022",16045,10649,5396
"Sarawak","May","05","2023",147533,84447,63086
"Sarawak","May","05","2024",207635,114235,93400
"Sarawak","November","11","2020",1025,963,62
"Sarawak","November","11","2021",811,764,47
"Sarawak","November","11","2022",98435,53936,44499
"Sarawak","November","11","2023",113059,62443,50616
"Sarawak","October","10","2020",642,562,80
"Sarawak","October","10","2021",570,546,24
"Sarawak","October","10","2022",95953,53122,42831
"Sarawak","October","10","2023",106667,59316,47351
"Sarawak","September","09","2020",848,754,94
"Sarawak","September","09","2021",674,652,22
"Sarawak","September","09","2022",90338,49614,40724
"Sarawak","September","09","2023",113165,62094,51071
"Selangor","April","04","2020",416,231,185
"Selangor","April","04","2021",9902,7215,2687
"Selangor","April","04","2022",121109,76340,44769
"Selangor","April","04","2023",549762,318485,231277
"Selangor","April","04","2024",728498,392344,336154
"Selangor","August","08","2020",5845,3899,1946
"Selangor","August","08","2021",6770,4677,2093
"Selangor","August","08","2022",385927,238039,147888
"Selangor","August","08","2023",782907,450015,332892
"Selangor","December","12","2020",4939,3647,1292
"Selangor","December","12","2021",45375,30454,14921
"Selangor","December","12","2022",521992,306365,215627
"Selangor","December","12","2023",792830,435062,357768
"Selangor","February","02","2020",551924,330947,220977
"Selangor","February","02","2021",6120,4659,1461
"Selangor","February","02","2022",38753,27675,11078
"Selangor","February","02","2023",495852,313058,182794
"Selangor","February","02","2024",804850,430744,374106
"Selangor","January","01","2020",817095,448654,368441
"Selangor","January","01","2021",6179,4663,1516
"Selangor","January","01","2022",42628,28890,13738
"Selangor","January","01","2023",528858,309683,219175
"Selangor","January","01","2024",825945,452257,373688
"Selangor","July","07","2020",5608,3905,1703
"Selangor","July","07","2021",5528,3946,1582
"Selangor","July","07","2022",331379,197924,133455
"Selangor","July","07","2023",790911,442236,348675
"Selangor","June","06","2020",1238,835,403
"Selangor","June","06","2021",4170,3174,996
"Selangor","June","06","2022",254120,156399,97721
"Selangor","June","06","2023",449001,270555,178446
"Selangor","June","06","2024",853615,445853,407762
"Selangor","March","03","2020",214336,133427,80909
"Selangor","March","03","2021",10026,7211,2815
"Selangor","March","03","2022",51030,35766,15264
"Selangor","March","03","2023",568760,351170,217590
"Selangor","March","03","2024",725189,397969,327220
"Selangor","May","05","2020",617,423,194
"Selangor","May","05","2021",6865,5134,1731
"Selangor","May","05","2022",212367,129850,82517
"Selangor","May","05","2023",597519,355223,242296
"Selangor","May","05","2024",819542,478907,340635
"Selangor","November","11","2020",5407,4101,1306
"Selangor","November","11","2021",14754,10506,4248
"Selangor","November","11","2022",467311,291966,175345
"Selangor","November","11","2023",649129,374771,274358
"Selangor","October","10","2020",5777,4295,1482
"Selangor","October","10","2021",10050,6806,3244
"Selangor","October","10","2022",443226,273074,170152
"Selangor","October","10","2023",643447,367295,276152
"Selangor","September","09","2020",5915,4187,1728
"Selangor","September","09","2021",7276,5165,2111
"Selangor","September","09","2022",382603,243982,138621
"Selangor","September","09","2023",704265,408872,295393
"Terengganu","April","04","2020",0,0,0
"Terengganu","April","04","2021",0,0,0
"Terengganu","April","04","2022",2,2,0
"Terengganu","April","04","2023",1,1,0
"Terengganu","April","04","2024",21,5,16
"Terengganu","August","08","2020",0,0,0
"Terengganu","August","08","2021",0,0,0
"Terengganu","August","08","2022",0,0,0
"Terengganu","August","08","2023",0,0,0
"Terengganu","December","12","2020",20,20,0
"Terengganu","December","12","2021",0,0,0
"Terengganu","December","12","2022",0,0,0
"Terengganu","December","12","2023",1,1,0
"Terengganu","February","02","2020",2,2,0
"Terengganu","February","02","2021",11,11,0
"Terengganu","February","02","2022",0,0,0
"Terengganu","February","02","2023",3,3,0
"Terengganu","February","02","2024",24,15,9
"Terengganu","January","01","2020",0,0,0
"Terengganu","January","01","2021",13,13,0
"Terengganu","January","01","2022",0,0,0
"Terengganu","January","01","2023",0,0,0
"Terengganu","January","01","2024",15,15,0
"Terengganu","July","07","2020",0,0,0
"Terengganu","July","07","2021",0,0,0
"Terengganu","July","07","2022",0,0,0
"Terengganu","July","07","2023",1,1,0
"Terengganu","June","06","2020",1,1,0
"Terengganu","June","06","2021",0,0,0
"Terengganu","June","06","2022",7,7,0
"Terengganu","June","06","2023",3,3,0
"Terengganu","June","06","2024",5,5,0
"Terengganu","March","03","2020",26,25,1
"Terengganu","March","03","2021",18,18,0
"Terengganu","March","03","2022",0,0,0
"Terengganu","March","03","2023",18,18,0
"Terengganu","March","03","2024",16,10,6
"Terengganu","May","05","2020",0,0,0
"Terengganu","May","05","2021",4,4,0
"Terengganu","May","05","2022",0,0,0
"Terengganu","May","05","2023",1,1,0
"Terengganu","May","05","2024",1,1,0
"Terengganu","November","11","2020",0,0,0
"Terengganu","November","11","2021",0,0,0
"Terengganu","November","11","2022",4,4,0
"Terengganu","November","11","2023",17,14,3
"Terengganu","October","10","2020",0,0,0
"Terengganu","October","10","2021",0,0,0
"Terengganu","October","10","2022",4,2,2
"Terengganu","October","10","2023",4,4,0
"Terengganu","September","09","2020",0,0,0
"Terengganu","September","09","2021",1,1,0
"Terengganu","September","09","2022",16,13,3
"Terengganu","September","09","2023",3,2,1
"W.P. Labuan","April","04","2020",2,2,0
"W.P. Labuan","April","04","2021",10,10,0
"W.P. Labuan","April","04","2022",31,22,9
"W.P. Labuan","April","04","2023",2291,1383,908
"W.P. Labuan","April","04","2024",1962,1161,801
"W.P. Labuan","August","08","2020",6,4,2
"W.P. Labuan","August","08","2021",9,9,0
"W.P. Labuan","August","08","2022",653,401,252
"W.P. Labuan","August","08","2023",2290,1426,864
"W.P. Labuan","December","12","2020",8,8,0
"W.P. Labuan","December","12","2021",10,10,0
"W.P. Labuan","December","12","2022",2316,1381,935
"W.P. Labuan","December","12","2023",3817,2308,1509
"W.P. Labuan","February","02","2020",2442,1634,808
"W.P. Labuan","February","02","2021",9,9,0
"W.P. Labuan","February","02","2022",17,17,0
"W.P. Labuan","February","02","2023",1946,1277,669
"W.P. Labuan","February","02","2024",2576,1590,986
"W.P. Labuan","January","01","2020",3950,2526,1424
"W.P. Labuan","January","01","2021",6,6,0
"W.P. Labuan","January","01","2022",12,12,0
"W.P. Labuan","January","01","2023",1622,1113,509
"W.P. Labuan","January","01","2024",1412,958,454
"W.P. Labuan","July","07","2020",11,8,3
"W.P. Labuan","July","07","2021",15,15,0
"W.P. Labuan","July","07","2022",64,36,28
"W.P. Labuan","July","07","2023",1360,934,426
"W.P. Labuan","June","06","2020",5,5,0
"W.P. Labuan","June","06","2021",0,0,0
"W.P. Labuan","June","06","2022",42,25,17
"W.P. Labuan","June","06","2023",1587,1042,545
"W.P. Labuan","June","06","2024",1595,1049,546
"W.P. Labuan","March","03","2020",912,627,285
"W.P. Labuan","March","03","2021",6,3,3
"W.P. Labuan","March","03","2022",12,12,0
"W.P. Labuan","March","03","2023",1425,978,447
"W.P. Labuan","March","03","2024",1590,1040,550
"W.P. Labuan","May","05","2020",2,2,0
"W.P. Labuan","May","05","2021",15,14,1
"W.P. Labuan","May","05","2022",28,21,7
"W.P. Labuan","May","05","2023",1741,1110,631
"W.P. Labuan","May","05","2024",2043,1209,834
"W.P. Labuan","November","11","2020",13,11,2
"W.P. Labuan","November","11","2021",3,3,0
"W.P. Labuan","November","11","2022",1234,848,386
"W.P. Labuan","November","11","2023",1651,1108,543
"W.P. Labuan","October","10","2020",5,5,0
"W.P. Labuan","October","10","2021",0,0,0
"W.P. Labuan","October","10","2022",1026,735,291
"W.P. Labuan","October","10","2023",1328,934,394
"W.P. Labuan","September","09","2020",10,8,2
"W.P. Labuan","September","09","2021",7,7,0
"W.P. Labuan","September","09","2022",940,641,299
"W.P. Labuan","September","09","2023",1469,998,471
